"Annee","jour","mois","Arneguy","Banca","Iraty","Sare","Urrugne","TotalJ"
1999,7,10,5648,1355,1025,1822,42,9892
1999,8,10,7011,3991,1410,2838,19,15269
1999,9,10,10346,3448,10883,2594,104,27375
1999,10,10,6274,3105,4712,4381,722,19194
1999,11,10,14140,8847,6647,7400,257,37291
1999,12,10,8837,3972,3226,0,25,16060
1999,13,10,7601,7113,0,1638,1504,17856
1999,14,10,1155,390,4200,318,106,6169
1999,15,10,2119,154,16476,563,84,19396
1999,16,10,36833,17201,8569,16062,29532,108197
1999,17,10,430,0,569,569,87,1655
1999,18,10,192,0,0,0,5,197
1999,19,10,359,60,260,0,6,685
1999,20,10,42,0,0,14,1321,1377
1999,21,10,395,48,355,228,260,1286
1999,22,10,1130,1324,143,180,2435,5212
1999,23,10,235,214,175,276,2809,3709
1999,24,10,336,83,2065,4190,527,7201
1999,25,10,1447,7735,1402,6809,36205,53598
1999,26,10,839100,402251,9983,167920,113467,1532721
1999,27,10,15980,42882,4713,104566,206865,375006
1999,28,10,26161,5836,2910,3422,8949,47278
1999,29,10,1416,93,89,156,850,2604
1999,30,10,1363,7,82,44,921,2417
1999,31,10,4155,1173,1509,533,572,7942
1999,1,11,1218,306,77,16,1890,3507
1999,2,11,831,0,342,1,6,1180
1999,3,11,2510,350,1014,16408,15162,35444
1999,4,11,114172,58307,1245,69575,115495,358794
1999,5,11,1210,339,54,5,1500,3108
1999,6,11,0,0,0,0,0,0
1999,7,11,0,0,0,885,0,885
1999,8,11,32266,11992,0,14015,6844,65117
1999,9,11,0,0,0,4,0,4
1999,10,11,0,0,0,0,0,0
2000,9,10,0,0,0,0,768,768
2000,10,10,0,0,0,0,0,0
2000,11,10,0,0,0,0,0,0
2000,12,10,30,128,0,84,621,863
2000,13,10,0,0,10,1,1,12
2000,14,10,1721,19,0,1202,1477,4419
2000,15,10,26,60,0,32,3,121
2000,16,10,0,0,0,0,0,0
2000,17,10,1,70,3141,1263,147,4622
2000,18,10,12645,35000,3872,38614,30809,120940
2000,19,10,204486,30826,25795,10617,2696,274420
2000,20,10,10,392,112,2,38125,38641
2000,21,10,0,0,0,0,10,10
2000,22,10,3513,2520,1290,13572,200,21095
2000,23,10,42545,240839,2852,156470,53242,495948
2000,24,10,120,8,44,88,0,260
2000,25,10,89590,99201,4788,256,0,193835
2000,26,10,9,217,0,310,70,606
2000,27,10,16794,7081,18871,38538,7365,88649
2000,28,10,15736,26678,603,3341,246366,292724
2000,29,10,1048,320,0,107,0,1475
2000,30,10,1315,344,0,3,1944,3606
2000,31,10,9,0,0,0,0,9
2000,1,11,86,20,0,6,6,118
2000,2,11,0,0,0,7,2,9
2000,3,11,1457,21,0,1,0,1479
2000,4,11,0,0,0,2,0,2
2000,5,11,585,5809,0,38,5900,12332
2000,6,11,16,5,0,3,0,24
2000,7,11,0,0,0,0,0,0
2000,8,11,0,0,0,0,0,0
2000,9,11,0,0,0,0,0,0
2001,9,10,225,98,78,178,44,623
2001,10,10,5113,830,2210,2135,18,10306
2001,11,10,15446,13505,12805,15299,10321,67376
2001,12,10,12279,7467,14600,971,292,35609
2001,13,10,397,181,994,262,105,1939
2001,14,10,5829,2445,4830,1136,429,14669
2001,15,10,6785,1380,2565,115,46,10891
2001,16,10,150879,22668,12683,32353,4859,223442
2001,17,10,1688,6931,605,173,8113,17510
2001,18,10,2971,3091,1024,2161,303,9550
2001,19,10,1500,3994,250,344,2084,8172
2001,20,10,1349,7200,370,363,4086,13368
2001,21,10,2520,361,489,71,16,3457
2001,22,10,23621,79350,2200,1487,85129,191787
2001,23,10,4900,1838,184,1159,0,8081
2001,24,10,58299,38553,796,82480,12059,192187
2001,25,10,12684,27836,939,36686,191630,269775
2001,26,10,32325,37417,3287,28074,21808,122911
2001,27,10,7010,44715,658,20776,17359,90518
2001,28,10,2117,3299,380,610,1058,7464
2001,29,10,40450,11195,1231,22216,7747,82839
2001,30,10,23319,16619,325,8445,25688,74396
2001,31,10,11318,1488,9053,501,24,22384
2001,1,11,11946,6095,0,11673,15245,44959
2001,2,11,194666,31878,0,35967,3270,265781
2001,3,11,19523,4780,0,5587,5189,35079
2001,4,11,2620,53,0,942,93,3708
2001,5,11,0,0,0,0,0,0
2001,6,11,0,0,0,0,2,2
2001,7,11,0,0,0,0,0,0
2001,8,11,0,0,0,0,0,0
2001,9,11,0,0,0,0,0,0
2002,7,10,225,0,0,0,0,225
2002,8,10,1763,704,291,723,10,3491
2002,9,10,0,0,0,0,0,0
2002,10,10,0,0,0,0,0,0
2002,11,10,0,0,0,0,0,0
2002,12,10,0,0,12,0,0,12
2002,13,10,16584,8224,1442,8055,8200,42505
2002,14,10,25622,6505,5648,3113,0,40888
2002,15,10,414,1357,120,0,550,2441
2002,16,10,28,59,35,0,0,122
2002,17,10,0,0,0,0,0,0
2002,18,10,426,654,70,57,0,1207
2002,19,10,38567,52284,1314,20394,60416,172975
2002,20,10,581,4176,1584,4327,54080,64748
2002,21,10,195,866,6527,249,69,7906
2002,22,10,5,12,0,0,0,17
2002,23,10,35,26,0,0,0,61
2002,24,10,1718,159,344,45,43,2309
2002,25,10,5,61,0,21,0,87
2002,26,10,13020,3468,3042,1624,0,21154
2002,27,10,44823,17254,169496,14833,47402,293808
2002,28,10,230517,78163,80557,307553,62389,759179
2002,29,10,61694,29339,3401,11281,13393,119108
2002,30,10,3701,16415,500,1340,117,22073
2002,31,10,0,0,0,25,0,25
2002,1,11,1249,41,0,292,0,1582
2002,2,11,3210,2321,0,2046,2979,10556
2002,3,11,0,5,0,11,0,16
2002,4,11,150,0,0,47,0,197
2002,5,11,36700,12642,0,52331,3354,105027
2002,6,11,167699,124098,0,62587,26358,380742
2002,7,11,0,0,0,0,0,0
2003,9,10,2,10,0,34,7,53
2003,10,10,47,38,255,80,3,423
2003,11,10,1559,1200,1942,1127,170,5998
2003,12,10,746,1299,6000,289,1933,10267
2003,13,10,846,1165,200,190,2,2403
2003,14,10,0,95,217,24,8,344
2003,15,10,1471,711,4100,553,3,6838
2003,16,10,40000,5000,23480,3650,200,72330
2003,17,10,7200,2000,5000,2300,200,16700
2003,18,10,4100,2300,3550,1500,100,11550
2003,19,10,0,0,500,5,100,605
2003,20,10,110,100,500,100,100,910
2003,21,10,6000,2486,3000,1250,0,12736
2003,22,10,10420,22000,13430,1700,8500,56050
2003,23,10,0,0,0,0,0,0
2003,24,10,170,500,0,3840,135,4645
2003,25,10,70000,59600,10000,100500,34000,274100
2003,26,10,20,265,0,70,200,555
2003,27,10,5100,8350,0,5200,2800,21450
2003,28,10,950,43110,500,820,20000,65380
2003,29,10,0,140,0,0,0,140
2003,30,10,0,0,0,0,0,0
2003,31,10,0,0,0,0,0,0
2003,1,11,30,0,0,45,0,75
2003,2,11,15000,13000,0,6180,17000,51180
2003,3,11,20000,106000,0,48000,77000,251000
2003,4,11,1720,148000,0,70000,350000,569720
2003,5,11,400,3700,0,100,184500,188700
2003,6,11,0,0,0,0,0,0
2003,5,11,0,0,0,0,0,0
2003,6,11,0,0,0,0,0,0
2003,7,11,0,0,0,0,0,0
2004,16,10,0,0,0,0,0,0
2004,17,10,2000,160,0,705,0,2865
2004,18,10,30800,11150,0,21308,9624,72882
2004,19,10,554,1200,0,1862,18204,21820
2004,20,10,205,1100,0,336,4600,6241
2004,21,10,37835,7839,0,18140,0,63814
2004,22,10,7839,32062,0,9050,176446,225397
2004,23,10,7189,21923,0,12767,102019,143898
2004,24,10,8785,17189,0,7434,31700,65108
2004,25,10,30697,17835,0,3708,1131,53371
2004,26,10,217,61,0,18,0,296
2004,27,10,0,0,0,0,0,0
2004,28,10,3096,8250,0,220,2254,13820
2004,29,10,605,250,0,120,25,1000
2004,30,10,37348,36180,0,26600,101318,201446
2004,31,10,4916,16856,0,223336,137517,382625
2004,1,11,80,150,0,84,0,314
2004,2,11,83500,407,0,2580,622,87109
2004,3,11,9305,18275,0,41389,61733,130702
2004,4,11,10000,3400,0,19911,3650,36961
2004,5,11,0,0,0,275,0,275
2004,6,11,11700,25087,0,56038,540,93365
2004,7,11,45380,7020,0,77416,5122,134938
2004,8,11,12171,46989,0,15100,6980,81240
2004,9,11,0,0,0,11,682,693
2004,10,11,0,0,0,0,0,0
2004,11,11,0,0,0,0,0,0
2005,15,10,112,824,0,300,2707,3943
2005,16,10,6500,13550,0,1600,16600,38250
2005,17,10,11700,17200,0,13000,72300,114200
2005,18,10,35,0,0,0,0,35
2005,19,10,300,1400,0,17,329,2046
2005,20,10,6550,21700,0,1920,32025,62195
2005,21,10,300,660,0,6,987,1953
2005,22,10,339,396,0,300,1992,3027
2005,23,10,27,437,0,0,66,530
2005,24,10,9470,9620,0,38700,109117,166907
2005,25,10,1040,11355,0,31140,150710,194245
2005,26,10,12500,42890,0,17475,182720,255585
2005,27,10,0,4200,0,4560,21300,30060
2005,28,10,0,40,0,88,191,319
2005,29,10,0,10,0,0,418,428
2005,30,10,150,1811,0,244,7119,9324
2005,31,10,45,372,0,48,0,465
2005,1,11,15560,2250,0,1600,1740,21150
2005,2,11,40380,7180,0,1425,94540,143525
2005,3,11,168760,30970,0,25700,343870,569300
2005,4,11,0,0,0,0,0,0
2005,5,11,220,100,0,0,35,355
2005,6,11,118000,53100,0,235425,178300,584825
2005,7,11,122000,38000,0,15000,14000,189000
2005,8,11,173,1438,0,2620,54430,58661
2005,9,11,0,0,0,0,0,0
2005,10,11,1600,3290,0,1960,2700,9550
2005,11,11,11240,220,0,2710,3420,17590
2006,16,10,433,7754,0,750,747,9684
2006,17,10,102,466,0,55,4400,5023
2006,18,10,101,230,0,6,880,1217
2006,19,10,12,30,0,3,428,473
2006,20,10,8,17,0,0,0,25
2006,21,10,103,850,0,27,1500,2480
2006,22,10,1141,1708,0,2648,5636,11133
2006,23,10,0,100,0,100,297,497
2006,24,10,9256,8000,0,1693,715,19664
2006,25,10,350,9048,0,259,45315,54972
2006,26,10,23457,52000,0,77172,37091,189720
2006,27,10,120000,89552,0,39903,18390,267845
2006,28,10,153480,27431,0,19389,1113,201413
2006,29,10,65412,8495,0,1604,1,75512
2006,30,10,86,1951,0,331,0,2368
2006,31,10,324,196,0,55,6,581
2006,1,11,0,0,0,0,0,0
2006,2,11,2115,99350,0,1929,76,103470
2006,3,11,138307,113152,0,147964,18000,417423
2006,4,11,21012,14995,0,1897,175,38079
2006,5,11,1596,4105,0,818,2074,8593
2006,6,11,4110,8025,0,3390,14341,29866
2006,7,11,228,1680,0,0,11605,13513
2006,8,11,491,777,0,1639,2797,5704
2006,9,11,8115,4887,0,4473,5560,23035
2006,10,11,736,8105,0,7394,21966,38201
2007,15,10,1315,2832,0,6550,0,10697
2007,16,10,13300,31000,0,610,940,45850
2007,17,10,603,60,0,465,62,1190
2007,18,10,17,3260,0,840,0,4117
2007,19,10,94210,14920,0,85100,0,194230
2007,20,10,139721,10021,0,5700,12,155454
2007,21,10,145500,35000,0,75000,4520,260020
2007,22,10,47270,6670,0,2180,200,56320
2007,23,10,115,845,0,190,0,1150
2007,24,10,552,8676,0,0,0,9228
2007,25,10,0,1430,0,0,0,1430
2007,26,10,510,1500,0,93,0,2103
2007,27,10,179590,37020,0,17340,2085,236035
2007,28,10,183010,86850,0,18600,30480,318940
2007,29,10,1030,2025,0,22,280,3357
2007,30,10,620,690,0,9,120,1439
2007,31,10,530,1965,0,5210,6990,14695
2007,1,11,21300,17890,0,15740,8810,63740
2007,2,11,180,1420,0,3140,1470,6210
2007,3,11,0,24,0,0,62,86
2007,4,11,0,0,0,0,0,0
2007,5,11,0,720,0,300,65,1085
2007,6,11,1070,25135,0,23540,22560,72305
2007,7,11,780,1677,0,25160,28190,55807
2007,8,11,1500,5000,0,69600,38500,114600
2007,9,11,3,0,0,0,0,3
2007,10,11,0,160,0,1700,11060,12920
2007,11,11,0,0,0,0,263,263
2008,15,10,11,0,0,42,0,53
2008,16,10,588,229,0,81,0,898
2008,17,10,10000,6000,0,45240,1978,63218
2008,18,10,77000,88690,0,279348,487514,932552
2008,19,10,14230,17950,0,181800,224760,438740
2008,20,10,18,614,0,26,355,1013
2008,21,10,92,28,0,0,0,120
2008,22,10,0,0,0,0,0,0
2008,23,10,9690,13390,0,25780,49100,97960
2008,24,10,14250,39060,0,36270,39185,128765
2008,25,10,44670,45270,0,75725,13700,179365
2008,26,10,34408,19982,0,47031,19900,121321
2008,27,10,0,77,0,15,0,92
2008,28,10,0,0,0,0,0,0
2008,29,10,0,0,0,0,0,0
2008,30,10,0,0,0,0,0,0
2008,31,10,826,906,0,87,400,2219
2008,1,11,10,7,0,0,0,17
2008,2,11,0,0,0,0,0,0
2008,3,11,0,0,0,0,0,0
2008,4,11,9735,65330,0,49520,80700,205285
2008,5,11,32,63,0,0,0,95
2008,6,11,0,3,0,0,0,3
2008,7,11,0,0,0,0,0,0
2008,8,11,316,607,0,110,2900,3933
2008,9,11,972,38,0,650,6440,8100
2008,10,11,526,2948,0,606,20540,24620
2008,11,11,0,0,0,0,0,0
2009,15,10,10000,300,0,4899,0,15199
2009,16,10,11000,4200,0,2200,70,17470
2009,17,10,2030,3600,0,3300,46,8976
2009,18,10,9800,10260,0,11600,2300,33960
2009,19,10,1700,6800,0,6400,38600,53500
2009,20,10,0,90,0,0,0,90
2009,21,10,150,60,0,0,0,210
2009,22,10,0,0,0,0,0,0
2009,23,10,120,130,0,0,0,250
2009,24,10,337,516,0,259,0,1112
2009,25,10,141,149,0,0,0,290
2009,26,10,188000,153000,0,84500,5800,431300
2009,27,10,7180,23600,0,9350,458000,498130
2009,28,10,3680,13830,0,6020,388,23918
2009,29,10,16490,48410,0,5400,990,71290
2009,30,10,20970,13300,0,5400,1725,41395
2009,31,10,178,460,0,66,100,804
2009,1,11,960,1030,0,0,37330,39320
2009,2,11,0,0,0,0,0,0
2009,3,11,0,0,0,0,0,0
2009,4,11,0,0,0,0,0,0
2009,5,11,0,0,0,0,0,0
2009,6,11,0,180,0,0,0,180
2009,7,11,0,0,0,0,0,0
2009,8,11,0,0,0,0,0,0
2009,9,11,15450,5740,0,34440,7770,63400
2009,10,11,429,0,0,3720,5595,9744
2009,11,11,0,0,0,0,0,0
2010,15,10,0,0,0,6760,1100,7860
2010,16,10,80,508,0,2035,415,3038
2010,17,10,3400,10220,0,25785,5185,44590
2010,18,10,28950,15095,0,29000,25170,98215
2010,19,10,1287,3836,0,11068,7740,23931
2010,20,10,0,0,0,0,0,0
2010,21,10,45180,67860,0,128050,222000,463090
2010,22,10,17280,6780,0,1810,17490,43360
2010,23,10,410,59,0,82,35,586
2010,24,10,0,0,0,0,1,1
2010,25,10,0,0,0,2996,1,2997
2010,26,10,5430,21320,0,106245,99110,232105
2010,27,10,562,5450,0,51600,29500,87112
2010,28,10,1140,990,0,750,6900,9780
2010,29,10,0,0,0,0,526,526
2010,30,10,0,5,0,0,0,5
2010,31,10,0,0,0,0,3,3
2010,1,11,0,0,0,0,0,0
2010,2,11,132,960,0,2760,12,3864
2010,3,11,31,260,0,0,1,292
2010,4,11,164,2395,0,89,2035,4683
2010,5,11,0,0,0,0,2,2
2010,6,11,1038,56,0,0,80,1174
2010,7,11,0,0,0,0,0,0
2010,8,11,0,0,0,0,0,0
2010,9,11,0,0,0,0,80,80
2010,10,11,0,0,0,0,0,0
2010,11,11,0,0,0,0,706,706
2011,15,10,1920,1724,0,3865,8550,16059
2011,16,10,20,71,0,183,13,287
2011,17,10,1600,3900,0,784,1064,7348
2011,18,10,86,440,0,51,14,591
2011,19,10,0,13,0,0,0,13
2011,20,10,2050,4150,0,9400,4380,19980
2011,21,10,68902,104579,0,80573,35600,289654
2011,22,10,218,698,0,340,12253,13509
2011,23,10,22,70,0,155,2797,3044
2011,24,10,0,0,0,0,0,0
2011,25,10,0,0,0,40,0,40
2011,26,10,481,2194,0,100,15150,17925
2011,27,10,334,14,0,46,400,794
2011,28,10,0,0,0,0,0,0
2011,29,10,946,2143,0,519,2613,6221
2011,30,10,6966,6755,0,5328,8200,27249
2011,31,10,6065,2500,0,8790,588423,605778
2011,1,11,0,2,0,5,0,7
2011,2,11,0,25,0,6,50,81
2011,3,11,0,0,0,0,0,0
2011,4,11,14436,21216,0,2125,1856,39633
2011,5,11,0,0,0,0,0,0
2011,6,11,0,0,0,0,0,0
2011,7,11,0,0,0,0,0,0
2011,8,11,500,1396,0,83,2,1981
2011,9,11,3318,102725,0,248,62390,168681
2011,10,11,20,93,0,4,5,122
2011,11,11,17498,59676,0,12652,131646,221472
2012,15,10,1340,616,0,1459,144,3559
2012,16,10,346,310,0,24,564,1244
2012,17,10,50,1026,0,94,4198,5368
2012,18,10,195,143200,0,12882,1792,158069
2012,19,10,0,0,0,0,0,0
2012,20,10,0,0,0,0,0,0
2012,21,10,0,0,0,0,0,0
2012,22,10,42899,37341,0,15641,3123,99004
2012,23,10,207643,103494,0,138169,109991,559297
2012,24,10,14048,11510,0,4390,103304,133252
2012,25,10,298,83,0,100,222,703
2012,26,10,0,0,0,0,0,0
2012,27,10,0,0,0,0,0,0
2012,28,10,52210,27535,0,55650,31400,166795
2012,29,10,52916,41713,0,166855,211880,473364
2012,30,10,2878,15548,0,5902,76075,100403
2012,31,10,14385,16300,0,50506,2297,83488
2012,1,11,0,0,0,0,30,30
2012,2,11,0,4,0,0,0,4
2012,3,11,0,47,0,0,52,99
2012,4,11,0,0,0,0,0,0
2012,5,11,0,0,0,0,0,0
2012,6,11,30,3080,0,8330,375,11815
2012,7,11,47555,147650,0,135465,217840,548510
2012,8,11,460,2350,0,10700,90995,104505
2012,9,11,0,0,0,0,0,0
2012,10,11,0,0,0,0,115,115
2012,11,11,0,0,0,0,0,0
2013,15,10,70,30,0,22,115,237
2013,16,10,61,15,0,32,2,110
2013,17,10,3642,1009,0,2779,0,7430
2013,18,10,64,2484,0,3996,41770,48314
2013,19,10,974,881,0,3006,2012,6873
2013,20,10,433,1018,0,204,1765,3420
2013,21,10,336,299,0,20,1619,2274
2013,22,10,45,35,0,17,1,98
2013,23,10,112,174,0,8,32,324
2013,24,10,4362,8981,0,1633,37619,52595
2013,25,10,1032,5984,0,995,500,8511
2013,26,10,7931,13042,0,10461,1355,32789
2013,27,10,378,433,0,11,493,1315
2013,28,10,659,50,0,19,0,728
2013,29,10,500,589,0,101,0,1190
2013,30,10,28976,28305,0,56579,24537,138397
2013,31,10,337714,299935,0,510642,80776,1229067
2013,1,11,5,48,0,22,147,222
2013,2,11,0,0,0,0,0,0
2013,3,11,0,0,0,0,0,0
2013,4,11,0,0,0,0,0,0
2013,5,11,0,0,0,0,0,0
2013,6,11,1320,246,0,0,0,1566
2013,7,11,1407,30447,0,4100,11417,47371
2013,8,11,3976,3956,0,420,0,8352
2013,9,11,960,460,0,59,0,1479
2013,10,11,0,0,0,0,0,0
2013,11,11,0,0,0,0,0,0
2014,15,10,580,24,0,6,246,856
2014,16,10,26,38,0,16,261,341
2014,17,10,448,864,0,819,4085,6216
2014,18,10,4240,11694,0,2269,8821,27024
2014,19,10,27131,30067,0,18122,703,76023
2014,20,10,1133,10360,0,7966,6379,25838
2014,21,10,7010,5043,0,492,12,12557
2014,22,10,23810,10064,0,5941,450,40265
2014,23,10,56640,27030,0,65778,18362,167810
2014,24,10,41430,47349,0,29945,17627,136351
2014,25,10,4700,9710,0,2588,1720,18718
2014,26,10,145845,206487,0,117081,73357,542770
2014,27,10,38413,102726,0,15451,18229,174819
2014,28,10,65,0,0,0,8046,8111
2014,29,10,3350,903,0,245,11465,15963
2014,30,10,2407,9902,0,346,47988,60643
2014,31,10,80,302,0,1924,63671,65977
2014,1,11,1309,20565,0,2573,1125,25572
2014,2,11,95,30,0,0,3,128
2014,3,11,0,0,0,0,0,0
2014,4,11,0,0,0,0,0,0
2014,5,11,0,0,0,0,0,0
2014,6,11,0,20,0,0,0,20
2014,7,11,0,0,0,0,0,0
2014,8,11,10,986,0,2413,7941,11350
2014,9,11,0,0,0,0,0,0
2014,10,11,542,3051,0,255,3441,7289
2014,11,11,0,596,0,440,70,1106
2015,15,10,300,1889,0,5207,3514,10910
2015,16,10,152,3386,0,3835,3368,10741
2015,17,10,2758,9077,0,15710,17727,45272
2015,18,10,19,35,0,2,163,219
2015,19,10,2619,5582,0,1285,1336,10822
2015,20,10,149584,30202,0,4272,172,184230
2015,21,10,1064,4572,0,8075,8899,22610
2015,22,10,60,1831,0,0,1,1892
2015,23,10,60,1066,0,430,1468,3024
2015,24,10,136,1137,0,317,701,2291
2015,25,10,216,11127,0,1721,19455,32519
2015,26,10,89,63,0,5,109807,109964
2015,27,10,120,246,0,0,16331,16697
2015,28,10,26,0,0,0,0,26
2015,29,10,0,0,0,1,158,159
2015,30,10,571,3196,0,1897,669800,675464
2015,31,10,802,2301,0,2001,111606,116710
2015,1,11,17629,83224,0,64965,79448,245266
2015,2,11,51318,59220,0,39159,26160,175857
2015,3,11,0,0,0,0,0,0
2015,4,11,25,250,0,0,10,285
2015,5,11,410,547,0,10,3367,4334
2015,6,11,1116,9915,0,2635,22529,36195
2015,7,11,2548,2646,0,70,39880,45144
2015,8,11,5498,2948,0,580,132625,141651
2015,9,11,750,246,0,142,40,1178
2015,10,11,12,1543,0,6,51,1612
2015,11,11,0,0,0,0,0,0
2016,15,10,6,20,0,40,260,326
2016,16,10,250,1921,0,2061,18821,23053
2016,17,10,88,319,0,70,38,515
2016,18,10,2051,3802,0,4658,0,10511
2016,19,10,36877,53060,0,59736,7053,156726
2016,20,10,8273,5641,0,2466,1256,17636
2016,21,10,13341,62041,0,100366,13850,189598
2016,22,10,2252,19847,0,59332,13930,95361
2016,23,10,69,76,0,0,200,345
2016,24,10,126,105,0,0,0,231
2016,25,10,5,59,0,0,0,64
2016,26,10,316,527,0,0,0,843
2016,27,10,654,426,0,0,0,1080
2016,28,10,3753,5488,0,5308,1131,15680
2016,29,10,45292,102208,0,268229,29876,445605
2016,30,10,10726,6580,0,2080,8,19394
2016,31,10,57941,79284,0,38091,106330,281646
2016,1,11,1790,2301,0,3,83405,87499
2016,2,11,12631,5705,0,597,1118,20051
2016,3,11,4,724,0,0,0,728
2016,4,11,6,33,0,0,0,39
2016,5,11,0,0,0,0,0,0
2016,6,11,0,0,0,0,0,0
2016,7,11,0,0,0,0,0,0
2016,8,11,12,0,0,0,0,12
2016,9,11,0,0,0,0,0,0
2016,10,11,0,0,0,0,0,0
2016,11,11,0,0,0,0,0,0
2017,15,10,69,36,0,108,2200,2413
2017,16,10,36,57,0,37,2363,2493
2017,17,10,243,1213,0,18,153,1627
2017,18,10,314,5248,0,3333,1988,10883
2017,19,10,0,0,0,0,0,0
2017,20,10,474,411,0,0,146,1031
2017,21,10,0,2,0,0,0,2
2017,22,10,0,0,0,0,0,0
2017,23,10,3396,12990,0,13619,21302,51307
2017,24,10,12168,16199,0,97225,292438,418030
2017,25,10,18945,28276,0,2548,109,49878
2017,26,10,647,405,0,3659,27104,31815
2017,27,10,0,9,0,21,40,70
2017,28,10,0,0,0,1914,0,1914
2017,29,10,3394,18029,0,111457,18980,151860
2017,30,10,0,0,0,0,0,0
2017,31,10,58537,165743,0,77851,14825,316956
2017,1,11,13,390,0,0,9933,10336
2017,2,11,92,18,0,1,1503,1614
2017,3,11,11,16,0,3,53790,53820
2017,4,11,0,4,0,4,350,358
2017,5,11,8,0,0,0,0,8
2017,6,11,5,0,0,0,0,0
2017,7,11,3644,5093,0,8970,93273,110980
2017,8,11,0,0,0,0,0,0
2017,9,11,0,0,0,0,0,0
2017,10,11,0,0,0,0,0,0
2017,11,11,0,0,0,0,0,0
2018,16,10,1457,113,0,576,5,2151
2018,17,10,1900,431,0,185,13,2529
2018,18,10,0,994,0,0,42,1036
2018,19,10,1652,1553,0,118,0,3323
2018,20,10,3,334,0,137,0,474
2018,21,10,5646,6890,0,991,0,13527
2018,22,10,8311,3143,0,2323,11,13788
2018,23,10,1054078,7450,0,8983,2544,1073055
2018,24,10,164,1072,0,1140,563,2939
2018,25,10,1438,333,0,0,10,1781
2018,26,10,70,0,0,0,0,70
2018,27,10,0,0,0,0,0,0
2018,28,10,520,72,0,0,860,1452
2018,29,10,0,150,0,0,0,150
2018,30,10,43,1423,0,0,17670,19136
2018,31,10,0,8520,0,0,35300,43820
2018,1,11,0,1,0,0,0,1
2018,2,11,0,9,0,40,0,49
2018,3,11,61303,117003,0,141095,20789,340190
2018,4,11,13501,272757,0,113244,898790,1298292
2018,5,11,0,916,0,61,1523,2500
2018,6,11,0,0,0,0,0,0
2018,7,11,0,0,0,0,0,0
2018,8,11,0,28,0,50,0,78
2018,9,11,0,0,0,0,0,0
2018,10,11,0,0,0,0,0,0
2018,11,11,17,27,0,0,0,44
2019,15,10,30,4,0,7,0,41
2019,16,10,84,100,0,2,158,344
2019,17,10,84,100,0,2,44,230
2019,18,10,15,0,0,0,0,15
2019,19,10,112,242,0,171,689,1214
2019,20,10,0,0,0,0,0,0
2019,21,10,1703,2717,0,628,0,5048
2019,22,10,4908,5759,0,3951,17994,32612
2019,23,10,957,149,0,5,69,1180
2019,24,10,5,0,0,0,0,5
2019,25,10,757,8483,0,10205,56701,76146
2019,26,10,548,3473,0,239,113668,117928
2019,27,10,498,4582,0,443,62196,67719
2019,28,10,2076,1766,0,800,10446,15088
2019,29,10,2500,6977,0,3575,4257,17309
2019,30,10,3105,2254,0,2806,8841,17006
2019,31,10,0,0,0,0,0,0
2019,1,11,0,0,0,0,0,0
2019,2,11,0,0,0,0,0,0
2019,3,11,0,0,0,0,0,0
2019,4,11,0,0,0,0,0,0
2019,5,11,0,0,0,0,0,0
2019,6,11,9,60,0,0,0,69
2019,7,11,95,0,0,0,0,95
2019,8,11,0,0,0,0,0,0
2019,9,11,0,1859,0,1110,0,2969
2019,10,11,0,0,0,0,3,3
2019,11,11,94,66,0,250,200,610
2020,15,10,1193,706,0,419,0,2318
2020,16,10,558,306,0,1132,387,2383
2020,17,10,2145,1605,0,3926,20795,28471
2020,18,10,2002,2898,0,5241,11000,21141
2020,19,10,1500,1838,0,6090,27924,37352
2020,20,10,18,25,0,2,0,45
2020,21,10,18,0,0,0,0,18
2020,22,10,1915,4658,0,250,259,7082
2020,23,10,84,64,0,81,0,229
2020,24,10,3155,3030,0,874,20332,27391
2020,25,10,247,382,0,288,0,917
2020,26,10,8,0,0,0,0,8
2020,27,10,0,42,0,0,0,42
2020,28,10,170,923,0,0,0,1093
2020,29,10,324295,158232,0,66509,45207,594243
2020,30,10,34460,359634,0,276494,90867,761455
2020,31,10,1370,2966,0,105,13695,18136
2020,1,11,307,74,0,17,44,442
2020,2,11,16585,8612,0,0,11585,36782
2020,3,11,0,0,0,0,0,0
2020,4,11,0,9572,0,20583,0,30155
2020,5,11,108500,115511,0,149542,388885,762438
2020,6,11,0,0,0,11,2676,2687
2020,7,11,0,0,0,0,28,28
2020,8,11,245,64,0,230,400,939
2020,9,11,1200,2189,0,0,2493,5882
2020,10,11,0,0,0,2705,14940,17645
2020,11,11,9760,9853,0,12190,65701,97504
2021,15,10,3200,488,0,90,5,3783
2021,16,10,10,12,0,23,48,93
2021,17,10,274,152,0,25,894,1345
2021,18,10,210,271,0,11,839,1331
2021,19,10,29,20,0,0,853,902
2021,20,10,4,10,0,0,0,14
2021,21,10,0,0,0,0,0,0
2021,22,10,20,0,0,0,350,370
2021,23,10,6662,2650,0,11588,3134,24034
2021,24,10,1780,2041,0,1401,111011,116233
2021,25,10,1680,1864,0,2054,2377,7975
2021,26,10,261,0,0,0,200,461
2021,27,10,4392,37131,0,30530,156542,228595
2021,28,10,0,10,0,15,6748,6773
2021,29,10,1,0,0,13,0,14
2021,30,10,13,0,0,0,0,13
2021,31,10,0,5,0,0,0,5
2021,1,11,0,0,0,0,0,0
2021,2,11,0,1,0,0,0,1
2021,3,11,0,0,0,0,0,0
2021,4,11,0,0,0,0,0,0
2021,5,11,0,130,0,1410,10,1550
2021,6,11,2666,36387,0,4045,2500,45598
2021,7,11,3250,8275,0,10726,82514,104765
2021,8,11,0,4,0,2,0,6
2021,9,11,300,3010,0,5564,59110,67984
2021,10,11,6686,20754,0,264289,589120,880849
2021,11,11,10560,8541,0,3721,4270,27092
